00000000000000000000
00000000000000000000
00000000000000000000
00000000000000000000
00000000022220000000
00000000000000000000
00000000000000000000
00022220000000000000
00000000000000000000
00000000000222200000
00000000000000000000
11111111111000011111
11111111111000011111
11111111111000011111
11111111111000011111