00000000000000000000
00000000000000000000
00000000000000000000
00000000000000000000
00000000044440000000
00000000000000000000
00000000000000000000
00044440000000000000
00000000000000000000
00000000000444400000
00000000000000000000
11111111111000011111
22222222222000022222
33333333333000033333
33333333333000033333